22,25,25,25,25,25,25,25,23,
26,2,33,33,12,33,33,2,27,
26,31,3,3,10,3,3,30,27,
26,31,3,3,10,3,3,30,27,
26,31,3,3,10,3,3,30,27,
26,31,3,3,10,3,3,30,27,
26,31,3,3,10,3,3,30,27,
26,2,32,32,11,32,32,2,27,
20,24,24,24,24,24,24,24,21
